NO     ./textures/bricks.xpm
SO    ./textures/obsidian.xpm
WE     ./textures/mossy_cobblestone.xpm
EA    ./textures/stone_bricks.xpm
F   220,100,0
     C     225,30,255

        1111111111111111111111111     1111111
        1000000000110000000000001     1000001
        1011000001110000000000001     1000001
        10010000000000000T000W001     1111111
111111111011000001110000000000001
100000000011000001110111111111111
11110111111111011100000010001
111101111  111110111010100101
11000001111101011100000010001
10000000000000000001000010001
10000000000000001101000000001
1100000111010101111101111000111
11110111 1110101 101111010001
11111111 1111111 111111111111
