NO     ./textures/cobblestone.xpm
SO    ./textures/mossy_stone_bricks.xpm
WE     ./textures/mossy_cobblestone.xpm
EA    
F   0,102,0
     C     51,153,255

        1111111111111111111111111     1111111
        1000000000110000000000001     1000001
        10110000011100000N0000001     1000001
        1001000000T00000000000001     1111111
11111111101100000111000000000001
100000000011000001110111111111111
11110111111111011100000010001
111101111  111110111010100101
11000001111101011100000010001
1000000000000000000100R010001
10000000000000001101000000001
11000001110101011111011110001
11110111 1110101 101111010001
11111111 1111111 111111111111
