NO     ./textures/cobblestone.xpm
SO    ./textures/mossy_stone_bricks.xpm
WE     ./textures/mossy_cobblestone.xpm
EA    ./textures/stone_bricks.xpm
F   0,102,0
     C     51,153,255

        1111111111111111111111111     1111111
        1000000000110000000000001     1000001
        1011000001110000000000001     1000001
        1001000000TTTTTT000000001     1111111
111111111011000001110000000000001
100000000011000001110111111111111
11110111111111011100000010001
111101111  111110111010100101
11000001111101011100000010001 R T
100000000000000000010000100011
10000N000000000011010000000001
110000011101010111110111100011
11110111 1110101 101111010001
11111111 1111111 111111111111
